45 15
nNNNNNNNNNNNNNNNNNNNNNNNNNNNNNNNNNNNNNNNNNNNe
W///////////////////////////////////////////E
W/////////////////////////////////////////O/E
W///////////////////////////////////////////E
W///////////////////////////////////////////E
W///////////////////////////////////////////E
W///////////////////////////////////////////E
W///B///////////////////////////////////////E
W///////////////////////////////////////////E
W///////////////////////////////////////////E
W///////////////////////////////////////////E
W///////////////////////////////////////////E
W///////////////////////////////////////////E
W///////////////////////////////////////////E
wSSSSSSSSSSSSSSSSSSSSSSSSSSSSSSSSSSSSSSSSSSSs