42 23
nNNNNNNNNNNNNNNNNNNNNNNNNNNNNNNNNNNNNNNNNe
W////////////////////////////////////////E
W////////////////////////////////////////E
W/////|SSSSSSSSSSSSSSSSSSSSSSSSl//W//////E
W/////_///////////////////////////W//////E
W/////E///////////////////////////W//////E
W/////E///////////////////////////W//////E
W/////E/////|SSSSSSSSSSSl/////////W//////E
W/////E/////^/////////////////////W//////E
W/////E/////W/////////|SSSSSSSSSSSW//////E
W/////-/////W//////////W//////////~//////E
W///////////W/////O////W///B/////////////E
W/////_/////W//////////W//////////^//////E
W/////E/////W/////////(NNNNNNNNNNNW//////E
W/////E/////~/////////////////////W//////E
W/////E/////|SSSSSSSSSSSl/////////W//////E
W/////E///////////////////////////W//////E
W/////E///////////////////////////W//////E
W/////-///////////////////////////W//////E
W/////|SSSSSSSSSSSSSSSSSSSSSSSSl//W//////E
W////////////////////////////////////////E
W////////////////////////////////////////E
wSSSSSSSSSSSSSSSSSSSSSSSSSSSSSSSSSSSSSSSSs