46 24
nNNNNNNNNNNe\\\\\\\\\\\\\\\\\\\\\\\\\\\\\\\\\\
W//////////E\\\\\\\\\\\\\\\\\\\\\\\\\\\\\\\\\\
W//////////E\\\\\\\\\\\\\\\\\\\\\\\\\\\\\\\\\\
W/////B////E\\\\\\\\\\\\\\\\\\\\\\\\\\\\\\\\\\
W//////////E\\\\\\\\\\\\\\\\\\\\\\\\\\\\\\\\\\
W//////////E\\\\\\\\\\\\\\\\\\\\\\\\\\\\\\\\\\
W//////////E\\\\\\\\\\\\\\\\\\\\\\\\\\\\\\\\\\
W//////////E\\\\\\\\\\\\\\\\\\\\\\\\\\\\\\\\\\
wSST/////rNNNNNNNNNNNNNNNNNe\\\\\\\\\\\\\\\\\\
\\\W/////E/////////////////E\\\\\\\\\\\\\\\\\\
\\\W/////E/////////////////LNNNNNNNNNNNNNe\\\\
\\\W|SSSlE////////ne/////////////////////E\\\\
\\\W/////E////////WE/////////////////////E\\\\
\\\W/////E////////WE///////_/////////////E\\\\
\\\W|SSSlE////////ws///////E/////////////E\\\\
\\\W/////E/////////////////E/////////O///E\\\\
\\\W/////E/////////////////E/////////////E\\\\
\\\W|SSSlLSSSSSSSSSSSSSSSSSs////VVVVVVVVVE\\\\
\\\W////////////////////////////VVVVVVVVVE\\\\
\\\W////////////////////////////VVVVVVVVVE\\\\
\\\W////////////////////////////VVVVVVVVVE\\\\
\\\W////////////////////////////VVVVVVVVVE\\\\
\\\W////////////////////////////VVVVVVVVVE\\\\
\\\wSSSSSSSSSSSSSSSSSSSSSSSSSSSSSSSSSSSSSs\\\\