48 22
nNNNNNNNNNNe\\\\\\\\\\\\\\\\\\\\\\\\nNNNNNNNNNNe
W//////////E\\\\\\\\\\\\\\\\\\\\\\\\W//////////E
W////O/////E\\\\\\\\\\\\\\\\\\\\\\\\W//////////E
W//////////E\\\\\\\\\\\\\\\\\\\\\\\\W/////B////E
W//////////E\\\\\\\\\\\\\\\\\\\\\\\\W//////////E
W//////////E\\\\\\\\\\\\\\\\\\\\\\\\W//////////E
W//////////E\\\\\\\\\\\\\\\\\\\\\\\\W//////////E
W//////////E\\\\\\\\\\\\\\\\\\\\\\\\W//////////E
W//////////E\\\\\\\\\\\\\\\\\\\\\\\\W//////////E
W//////////E\\\\\\\\\\\\\\\\\\\\\\\\W//////////E
W//////////E\\\\\\\\\\\\\\\\\\\\\\\\W//////////E
W//////////E\\\\\\\\\\\\\\\\\\\\\\\\W//////////E
W//////////ENNNNNNNNNNNNNNNNNNNNNNNNW//////////E
W//////////E////////////////////////W//////////E
W//////////E///////////_////////////W//////////E
W//////////E///////////E////////////W//////////E
W//////////E///////////E////////////W//////////E
W//////////E///////////E////////////W//////////E
W//////////E///////////E////////////W//////////E
W//////////-///////////E////////////~//////////E
W//////////////////////E///////////////////////E
wSSSSSSSSSSSSSSSSSSSSSSSSSSSSSSSSSSSSSSSSSSSSSSs