46 24
nNNNNNNNNNNNNe\\\\\\\\\\\\\\\\\\\\\\\\\\\\\\\\
W////////////E\\\\\\\\\\\\\\\\\\\\\\\\\\\\\\\\
W////////////E\\\\\\\\\\\\\\\\\\\\\\\\\\\\\\\\
W////B///////E\\\\\\\\\\\\\\\\\\\\\\\\\\\\\\\\
W////////////E\\\\\\\\\\\\\\\\\\\\\\\\\\\\\\\\
W////////////E\\\\\\\\\\\\\\\\\\\\\\\\\\\\\\\\
W////////////E\\\\\\\\\\\\\\\\\\\\\\\\\\\\\\\\
W//////////_/E\\\\\\\\\\\\\\\\\\\\\\\\\\\\\\\\
wSST///////ENNNNNNNNNNNNNNNNNe\\\\\\\\\\\\\\\\
\\\W///////E/////////////////E\\\\\\\\\\\\\\\\
\\\W///////E/////////////////LNNNNNNNNNNNNNe\\
\\\W//|SSSSE///////ENW/////////////////////E\\
\\\W///////E////O//E\W/////////////////////E\\
\\\W///////E///////E\W///////^/////////////E\\
\\\WSSSSl//E///////ESW///////W/////////////E\\
\\\W///////E/////////////////W/////////////E\\
\\\W///////E/////////////////W/////////////E\\
\\\W//|SSSSESSSSSSSSSSSSSSSSSW////VVVVVVVVVE\\
\\\W//////////////////////////////VVVVVVVVVE\\
\\\W//////////////////////////////VVVVVVVVVE\\
\\\W//////////////////////////////VVVVVVVVVE\\
\\\W//////////////////////////////VVVVVVVVVE\\
\\\W//////////////////////////////VVVVVVVVVE\\
\\\wSSSSSSSSSSSSSSSSSSSSSSSSSSSSSSSSSSSSSSSs\\