38 26
nNNNNNNNNNNNNNNNNNNNNNNNNNNNNNNNNNNNNe
W////////////////////////E/////W//B//E
W////////////////////////E/////W/////E
W/////_/////^////VVVV////E/////W/////E
W/////ENNNNNW////VVVV////E/////W/////E
W/////E/////W////VVVV////E/////W/////E
W/////E/////W////VVVV////E/////W/////E
W/////E/////W////VVVV////E/////W/////E
W/////E/////W////VVVV////E/////W/////E
W/////E/////W////VVVV////E/////W/////E
W/////E/////W////VVVV////E/////W/////E
W/////E/////W////VVVV////E/////W/////E
W/////E/////W////VVVV////E/////W/////E
W/////E/////W////VVVV////E/////W/////E
W/////E/////W////VVVV////E/////W/////E
W/////E/////W////VVVV////E/////W/////E
W/////E/////W////VVVV////E/////W/////E
W/////E/////W////VVVV////E/////W/////E
W/////E/////W////VVVV////E/////W/////E
W/////E/////W////VVVV////E/////W/////E
W/////E/////W////VVVV////E/////W/////E
W/////E/////W////VVVV////ESSSSSW/////E
W/////E/////W////VVVV////-/////~/////E
W//O//E/////W////////////////////////E
W/////E/////W////////////////////////E
wSSSSSSSSSSSSSSSSSSSSSSSSSSSSSSSSSSSSs