48 22
nNNNNNNNNNNe\\\\\\\\\\\\\\\\\\\\\\\\nNNNNNNNNNNe
W//////////E\\\\\\\\\\\\\\\\\\\\\\\\W//////////E
W////O/////E\\\\\\\\\\\\\\\\\\\\\\\\W//////////E
W//////////E\\\\\\\\\\\\\\\\\\\\\\\\W/////B////E
W//////////E\\\\\\\\\\\\\\\\\\\\\\\\W//////////E
W//////////E\\\\\\\\\\\\\\\\\\\\\\\\W//////////E
W//////////E\\\\\\\\\\\\\\\\\\\\\\\\W//////////E
W//////////E\\\\\\\\\\\\\\\\\\\\\\\\W//////////E
W//////////E\\\\\\\\\\\\\\\\\\\\\\\\W//////////E
W//////////E\\\\\\\\\\\\\\\\\\\\\\\\W//////////E
W//////////E\\\\\\\\\\\\\\\\\\\\\\\\W//////////E
W//////////E\\\\\\\\\\\\\\\\\\\\\\\\W//////////E
W//////////ENNNNNNNNNNNNNNNNNNNNNNNNW//////////E
W//////////E////////////////////////W//////////E
W//////////E////////////////////////W//////////E
W//////////E///////////W////////////W//////////E
W//////////E///////////W////////////W//////////E
W//////////E///////////W////////////W//////////E
W//////////E///////////W////////////W//////////E
W//////////////////////W///////////////////////E
W//////////////////////W///////////////////////E
wSSSSSSSSSSSSSSSSSSSSSSSSSSSSSSSSSSSSSSSSSSSSSSs