57 19
\\\\\\\\\\\\\\nNNNNNe\\\\nNNNNNe\\\\nNNNNNe\\\\\\\\\\\\\\
\\\\\\\\\\\\\\W/////E\\\\W/////E\\\\W/////E\\\\\\\\\\\\\\
nNNNNNNNNe\\\\W/////E\\\\W/////E\\\\W/////E\\\\nNNNNNNNNe
W////////E\\\\W/////E\\\\W/////E\\\\W/////E\\\\W////////E
W////////E\\\\W/////E\\\\W/////E\\\\W/////E\\\\W////////E
W////////LNNNNJ/////LNNNNJ/////LNNNNJ/////LNNNNJ////////E
W///////////////////////////////////////////////////////E
W///////////////////////////////////////////////////////E
W///B/////////rNNNNNNNNNNNNNNNNNNNNNNNNNNNT/////////////E
W/////////////W///////////////////////////E/////////////E
W/////////////LSSSSSSSSSSSSSSSSSSSSSSSSSSSJ/////////////E
W///////////////////////////////////////////////////////E
W///////////////////////////////////////////////////////E
W////////rSSSST/////rSSSST/////rSSSST/////rSSSST////////E
W////////E\\\\W/////E\\\\W/////E\\\\W/////E\\\\W////////E
W////////E\\\\W/////E\\\\W/////E\\\\W/////E\\\\W////////E
wSSSSSSSSs\\\\W/////E\\\\W/////E\\\\W/////E\\\\wSSSSSSSSs
\\\\\\\\\\\\\\W/////E\\\\W/////E\\\\W/////E\\\\\\\\\\\\\\
\\\\\\\\\\\\\\wSSSSSs\\\\wSSSSSs\\\\wSSSSSs\\\\\\\\\\\\\\