*************|***^**
*************|***^**
************b|***^**
*****b*****<-|***^**
*****t*******|***^**
***<-|*******|***^**
***j*|*******|******
***j*|**************
***j*|*****<-*--->**
***j*|b******|******
***j*|<******|******
*t***|*******|******
*|***|*******|******