i....i......i....^..
i....i......=....^..
i....i....<-~>...^..
i....i......i....^..
i....=......i....^..
i..<-~->....i....^..
i....i......i......J
i..j.i..j...i.b.....
i..j.i..j...i->.....
=....i......i.......
~....i->...bi.......
i->..i....<-i.......
i....i......i.......