b*****i***********^*
->****i***********^*
******************^*
****<-************^*
******i***********^*
******i***********^*
->****i*************
******i**t******ti**
****<-i-*i*******i**
******ib*i*******i**
******i>*i*******i**
**t***i**i*******i**
**i***i**i*******i**