******************^*
.**j***j**********^*
->*********t******^*
***********i******^*
***********i******^*
***********=***t****
****t*****<~>**i****
****i******i***i**.*
***ji******i***i**t*
****i***t**i***i**i*
****ib**i**i***i>*i*
-->*i>**i**i***i*bi*
****i***i**i***i*<i*