b****************^**
->***************^**
****t*******t*******
****i************t**
***ji****<--*>***i**
***ji*******i****i**
***ji*******ij***i**
****i***t***i****i**
***<i***i***i->**i**
****i**bi***i****i**
****i*<-i***i****i**
-->*i***i*<-i***bi**
****i***i***i***<i**