i****i******i****^**
i****i***********^**
i****i****<-*>***^**
i****i******i****^**
i***********i****^**
i**<-*->****i****^**
i****i******i*******
i**j*i*j****i*b*****
i**j*i*j****i->*****
i****i******i*******
i****i->***bi*******
i->**i****<-i*******
i****i******i*******