*****j*****j******^*
*****j*****j.*****^*
*****j*****j******^*
*****j************^.
******************^*
b****************J^*
->****************^*
********************
***************b****
****t******t******t*
****i******i******i*
****i******i******i*
*t**i******i******i*