b*****i***********^*
->****i***********^*
******=***********^*
****<-~***********^*
******i***********^*
******i***********^*
->****i*************
******i**t******.t**
****<-i.*i*******i**
******ib*i*****<-i**
******i>*i*******i**
*.t***i**i*******i**
*<i***i**i*******i**