*****j*****j******^*
*****j*****jb*****^*
*****j*****j******^*
*****j************^*
******************^*
b*****************^*
->****************^*
********************
***************b****
****t******t******t*
****i******i******i*
****i******i******i*
*t**i******i******i*