..........i.......^.
.........bi.......^.
........<-i.......^.
..........i.......^.
..........=.........
...<------~------>..
..........i.........
......b...=.........
---><-----~----->...
..........i.........
..........=.........
----------~------->.
..........i.........