******i**********^**
******i**********^**
******i**********^**
******i**********^J*
******i*************
******i**********t**
******i**********i**
******i*******b**i**
******i*****<----i**
******i**********i**
*****b=**********i**
*t**<-~->********i**
*i****i**********i**