***************^****
***************^****
********************
***************t****
******b********i****
******t********i****
****<-i--->****i****
******i********=**b*
****j*i*******<~-->*
****j*i********i****
******i********i****
**t***i********i****
**i***i********i****