********************
*****--*************
************--******
******************^*
************-*******
********************
*****************-**
*******-************
************-*******
******^**************
************--*-****
-->*****************
********************