*******************^
*******************^
-->****************^
*******************^
**j****************^
*********t*********^
*********i*********^
******<--i*********^
*********i*********^
******j**i*********^
******t**i******t**^
->****i**i>*****i**^
******i**i******i**^