*****************^**
*****************^**
*****************^**
*****************^**
******b**********^**
********************
*********t*******t**
*********i*******i**
********<i***t***i**
*********i***i***i**
*********ib**i***i**
--->***t.i>**i***i**
*******i.i***i***i**