******i**********^**
******i**********^**
******i**********^**
******i**********^**
******i*************
******i**********t**
******i**********i**
******i*******b**|**
******i*****<----|**
******i**********|**
*****b=**********|**
*t**<-~->********|**
*i****i**********|**