*******************^
b******************^
-->****************^
****************J**^
**j****************^
*********t*********^
*********i*********^
******<--i*********^
*********i*********^
******j**i*********^
******.**ib*****t**^
->**t*.**i>*****i**^
****i*.**i******i**^