-----------------^--
-----------------^--
-----------------^--
-----------------^--
-----------------^--
--------------------
---------t-------t--
---------i-------i--
--------<i---t---i--
---------i---i---i--
---------i---i---i--
--->----ti>--i---i--
--------ii---i---i--