...............i..^.
.....j.........i....
...............i..^.
......~...~....=....
..........i...<~>...
.x........i....i....
-->.......i....i.j..
..........i....=....
..........i...<~>...
.....~....i....i....
.....i...bi..xbi....
-->..i...<i..<-i....
.....i....i....i....