i.....i..j..j..i...^
ib....i..j..j..=b..^
i->...i.......<~>...
i.....i........i....
i...x.i........i...t
i...<-i........i...i
i.....i->......=...i
i.x...i......<-~->.i
i->...i........i...i
i.....=....t...i...i
i..<--~>...i...i...i
i.....i....i...i...i
i->...i....i...i...i