..........i.j.....^.
..........i.j.....^.
..........i.j.....^.
..........i.jb....^.
..........i.j.....^.
.b........i.j.....^.
....t.....i.j.....^.
....i...x.i.......^.
....i...<-i>........
..x.......i.........
..<-.>.............<
.t..i....<.>....b...
.i..i.....i.....t...