i......j.........^..
i.b....j.........^..
i->....j.........^..
i......j............
i...................
i...........t.......
i...........i.......
i...........i.......
i.....t.....i.......
i.....i.....i.......
i.....i....<i.......
i->...ib....i.......
i.....i>....i.......