i......j............
i.b..............^..
i->....j............
i................^..
i......j............
i................^..
i...........~.......
i.........<-i.......
i.....~.....i.......
i.....i.....i.......
=.....i....<i.......
~->...ib....i....J..
i.....i>....i.......