.....j.........i..^.
.....j.........i..^.
.....j.........i..^.
.....j....t.........
..........i...<.>...
.x........i....i....
-->.......i....ij...
..........i.........
..........i...<.>...
.....t....i....i....
.....i...bi..xbi....
-->..i...<i..<-i....
.....i....i....i....