.....j....i......i.^
.b...j...<.>.......^
->...j....i.....<.->
..........i......i..
..........i......i..
..........i......i..
..........i...t..i..
..........i...i..i..
..............i..i..
.........<.>..i..i..
..........i...i..i..
.....xt...ib..i..i..
.t...<i...i>..i..i..