.....j....=......i.^
.b.......<~>.....=.^
->...j....i.....<~->
..........i......i..
..........i......i..
..........i......i..
..........i...t..i..
..........i...i..i..
..........=...i..i..
.........<~>..i..i..
..........i...i..i..
.....xt...ib..i..i..
>t...<i...i>..i..i..