..........i.j.......
..........i.....J.^.
..........i.j.......
..........i..b....^.
..........i.j.......
.b........i.......^.
....~.....i.j.......
....i...x.i.......^.
....i...<-i>........
..x.=.....i.........
..<-~>....=.......<-
....i...<-~>........
.i..i.....i.....~...