i...................
i.b....j.........^..
i->.................
i......j.........^..
i...................
i...................
i...........~.......
i...........i.......
i.....~.....i.......
i.....i.....i.......
=.....i....<i.......
~->...ib....i....J..
i.....i>....i.......