.....j....=......i.^
.b.......<~>.....i.^
->...j....i......=..
..........i.....<~->
..........i......i..
..........i......i..
..........i...~..i..
..........i...i..i..
..........=...i..i..
.........<~>..i..i..
..........i...i..i..
.....x~...ib..i..i..
--...<i...i>..i..i..