.....j....=......i.^
.b.......<~>.....=.^
->...j....i......=..
..........i.....<~->
..........i......i..
..........i......i..
...b......i...~..i..
..........i...i..i..
..........=...i..i..
.........<~>..i..i..
..........i...i..i..
.....x~...ib..i..i..
--...<i...i>..i..i..