.......j....j....^..
.......j....j....^..
.......j....j....^..
....................
....t...........t...
...ji...........i...
....i>..........i...
...ji..........bi...
....ib.........<i...
...ji->.........i...
....i...........i...
....i....b....<-i...
.t..i....t......i...