x........ii^.......x
x........==^...J...x
x........~~........x
x----....ii........x
x........ii........x
x........==........x
x.......-~~-.......x
x........ii........x
x........==.....---x
x........~~........x
x..xx..xxiixx..xx..x
x--------ii--------x
xxxxxxxxxiixxxxxxxxx