.................^..
.................^..
.................^..
....................
..........J.........
....................
.........__.........
.........ii.........
........-ii.........
.........ii.........
.......--ii.........
.........ii.........
---------ii.........