.......j......i...^.
b......j......i...^.
--.....j......=.....
............--~-....
............j.i.....
............j.i.....
..............i..._.
....._......x.i..ji.
--...i.....---i..ji.
.....i........i...i.
.....i........ib..i.
___..i........i_..i.
iii..i........i...i.