.....i......i....^..
bx...i......i....^..
---..i....x.=....^..
.....i....--~-...^..
...x.=.x....i....^..
...--~--....i.......
.....i.....xi.......
--...i....--i.......
.....ix.....i.......
.j...i--..b.i..b....
.....i....--i.......
.....i......i.......
__...i......i.......