.......j......i...^.
b......j......i...^.
->.....j......=.....
............<-~>....
............j.i.....
............j.i.....
..............i...t.
.....t......x.i..ji.
->...i.....<--i..ji.
.....i........i...i.
.....i........ib..i.
..t..i........i>..i.
..i..i........i...i.