.......j....j....^..
....................
.......j....j....^..
....................
...._.....b....._...
...-i.....-....Ji...
....i-..........i...
...ji..........bi...
....i..........-i...
...ji--.........i...
....i...........i...
....i....b....--i...
__..i...._......i...