x........ii^.......x
x........==^.......x
x........~~........x
x>.......ii........x
x........ii........x
x........==........x
x.......<~~>.......x
x........ii........x
x........==.......<x
x........~~........x
x..xx..xxiixx..xx..x
x--------ii--------x
xxxxxxxxxxxxxxxxxxxx