.......j....j....^..
.......j....j....^..
.......j....j....^..
....................
...._..........._...
...ji...........i...
....i-..........i...
...ji..........bi...
....ib.........-i...
...ji--.........i...
....i...........i...
....i....b....--i...
__..i...._......i...