.......j......i...^.
b.............i...^.
--............=.....
..-.........--~-....
..............i.....
..-.........j.i.....
..............i..._.
....._......x.i...i.
--...i.....---i..-i.
.....i........i...i.
.....i........ib..i.
___..i........i_..i.
iii..i........ii..i.