.......j......i...^.
b......j......i...^.
->.....j......=.....
............<-~>....
............j.i.....
............j.i.....
..............i..._.
....._......x.i..ji.
->...i.....<--i..ji.
.....i........i...i.
.....i........ib..i.
.._..i........i>..i.
..i..i........i...i.