.................^..
.................^..
.................^..
....................
......J..............
....................
.........__.........
........jii.........
........jii.........
........jii.........
........jii.........
.........ii.........
---------ii.........