*************i***^**
*************i***^**
************bi***^**
*****.*****<-i***^**
*****t*******i***^**
***<-i*******i***^**
***.*i*******i******
***j*i*******=******
***.*i*****<-~--->**
***j*ib******i******
***j*i>******i******
*t***i*******i******
*i***i*******i******