********************
********************
*****************<--
*********b*******^**
*********t*******^**
*********i*******^*b
****t****i**********
****i***********t***
***ji**<-*->****i***
***ji****i******i***
****ib***i******i***
****i->**i>*****i***
*t**i****i******i***