*******************^
**********b********^
**********j********^
**********j********j
*b*****************j
-->**t********t****j
*****i********i****j
*****i***t****=****j
*****=***i**<-~->***
***<-~->*i****i*****
*****i***i**j*i*****
-->**i***ib*j*i*****
*****i***i>***i*****