**|******|********^*
**|******|********^*
**|b*****|**********
**|->****|*****<----
**|******=**********
**|****<-~->*****t**
**|******|*******|*b
**|******|*******|->
*****t***|*<-----|**
*****|***|*******|**
****<|***|*b*****|**
*t***|***|->*****|**
*i***|***|*******|**