***************^****
****<-i********^****
******i*************
*t****i********t*b**
*|b***i********i****
*|->**i********i****
*|****i****t***i****
*|****=**<-i***i****
*|**<-~->**i**<i****
******i****i***i****
******i****ib**i****
-->***i****i>**i****
*|****i****i***i****