***************^****
****<-i********^****
*t****i*************
*i****i********t*.**
*ib***i********i****
*i->**i********i****
*i****i****t***i****
*i****=**<-i***i****
*i**<-~->**i**<i****
*i****i****i***i****
*=****i****ib**i****
-~>***i****i>**i****
*i****i****i***i****