**i******i********^*
**i******i********^*
**ib*****i**********
**i->****i*****<----
**i******=**********
**i****<-~->*****.**
**.******i*******t*b
**.******i*******i->
*****t***i*<-----i**
*****i***i*******i.*
****<i***i*b*****iJ*
*t***i***i->*****i**
*i***i***i*******i**