*******************^
*******************^
-->****************^
**j****************^
*******************^
*********t*********^
*********i*********^
******<--i*********^
******j**i*********^
*********i*********^
*****tt**i******t**^
->****|**i>*****i**^
******|**i******i**^