********************
********************
*--*****--**********
*****************^**
************-*******
********************
*****--*********--**
********************
***********-********
********************
******-*************
*--*****************
********************