******i**********^**
******i**********^**
******i**********^**
******i**********^**
******i*************
******i**********t**
******i**********i**
******i**********|**
******i*****<----|**
******i**********|**
*****************|**
*t**<-i->********|**
*i****i**********|**