***************^****
***************^****
********************
***************t****
***************i****
******t********i****
****<-i--->****i****
******i********i****
****j*i-*******i****
****j*i********i****
******i********i****
**t***i********i****
**i***i********i****