********************
******|*************
******|*************
******|*************
******|**********^**
******|**********t**
******|**********|**
******|**********|**
******|*****<----|**
******|**********|**
*****************|**
*tt*<-|->********|**
*i****|**********|**