*******************^
*******************^
-->****************^
**j****************^
*******************^
********tt*********^
*********i*********^
******<--i*********^
******j**i*********^
*********i*********^
*****tt**i*****tt**^
->****i**i>*****i**^
******i**i******i**^