******|**********^**
******|**********^**
******|**********^**
******|**********^**
******|*************
******|**********t**
******|**********|**
******|**********|**
******|*****<----|**
******|**********|**
*****************|**
*tt*<-|->********|**
*i****|**********|**