*****************^**
*****************^**
*****************^**
*****************^**
*****************^**
********************
*********t*******t**
*********i*******i**
********<i**tt***i**
*********i***i***i**
*********i***i***i**
--->***t*i>**i***i**
********ii***i***i**