.-+-+-+-+/
-.......+*
..........
..........
..........
..........
.....*....
.../......
.......+..
..++--.#..