.;-;+;-;+;-;+;-;+;/
-;.;.;.;.;.;.;.;+;*
.;.;.;.;.;.;.;.;.;.
.;.;.;.;.;.;.;.;.;.
.;.;.;.;.;.;.;.;.;.
.;.;.;.;.;.;.;.;.;.
.;.;.;.;.;.;.;.;.;.
.;.;.;.;.;.;.;.;.;.
.;.;.;.;.;.;.;.;.;.
.;.;.;.;.;.;.;.;.;.